2111611111
7   0    2
1    22322
9    2   2
8    4   2
1        4
11141    2
1   5    1
1        1
1115111511
