2111511111
7        2
1    22322
5    2   2
11   4   2
111      4
11141    2
1   5    1
1        1
1115111611
