2111611111
7   0    2
1    22322
5    2   2
9    4   2
8        4
11141    2
1   5    1
1        1
1115111511
