1232211122
1        4
3   111  2
2   5    1
2   111662
5        4
1122     1
1    11  1
3    4   1
2212315211